R 1920 1080
NO ./texture/iii
SO ./texture/iii
WE ./texture/iii
EA ./texture/iii
S ./texture/iii
F 220,100,0
C 225,30,25
   1111111  1111111111111
1000000000110000000000001
1011000001110000002000001
1001000000000000000000001
1111111110110000011100001
1000000000110000011101111
1111011111111101110001001
1111011111111101110001001
1100000011010101110000001
1000000N00000000110000001
1000000000000000110101001
1100000111010101111101111
1111011101110101010111101
111111  11111111111111111111