R 1920 1080
NO ./texture/bluestone.xpm
SO ./texture/purplestone.xpm
WE ./texture/greystone.xpm
EA ./texture/redbrick.xpm
S ./texture/bluestone.xpm
F 0,0,0
C 0,0,254

    1111111111111111111111111
    1000000000000000000000001
    1000000000000000000011111
111111111000N000000000001
1000000000000000000000001
1111111111111111011111111
1111111111111111011111111
1001111111111111011100001111111
1011000000000000000100000000001
1011000000000000000100000000001
1011000000000000000000001111111
1011000000000000000100001
1001011111111111111100001
1000000111010000000000001
1011000000000011110000001
111111111111111  11111111