R 1920 1080
NO ./texture/iii
SO ./texture/iii
WE ./texture/iii
EA ./texture/iii
S ./texture/iii
F 220,100,0
C 225,30,25
    1111111111111111111111111
    1000000000000000000000001
    1000000000000000000011111
111111111000E000000000001
1000000000000000000000001
1111111111111111111111111
1111111111111111111111111
1001111111111111111100001111111
1011000000000000000100000000001
1011000000000000000100000000001
1011000000000000000100001111111
1011000000000000000100001
1001011111111111111100001
1000000111010000000000001
1011000000000011110000001
111111111111111  11111111