R 1920 1080
NO ./texture/iii
SO ./texture/iii
WE ./texture/iii
EA ./texture/iii
S ./texture/iii
F 220,100,0
C 225,30,25
1111111111111111111111111
1000000000000000000000001
1011000001110000002000001
1001000000000000000000001
1011111110110000011100001
1000000000110000011100001111111
1011011111111101110001000000001
1011011111111101110001000000001
1000000011010101110000001111111
1000000N00000000110000001
1000000000000000110101001
1000000111010000000000001
1000000000000011110000001
111111111111111  11111111