C 255,20,30
R 214032 214220
NO ./texture/colorstone.xpm
SO ./texture/greystone.xpm
EA ./texture/wood.xpm
WE ./texture/purplestone.xpm

S ./texture/barrel.xpm
F 111,122,222

111111111111111111111111111111
111111111000200000000000011111
100000000000000000111000100001
110000100000000000000000001111
100001111111000000020000111111
1111111000000000W0000000000001
111100000000001100000002000011
1000000000000000000000000000010
110000000000011110000000000011
100000000000111000000000000011
110000000000111000000000001111
110000000001111000000000000111
111111111111111111111111111111111
