R 2560 50
NO ./texture/bluestone.xpm
SO ./texture/purplestone.xpm
WE ./texture/greystone.xpm
EA ./texture/redbrick.xpm

S ./texture/barrel.xpm
F 255,0,0
C 0,0,254



    111111111111111111111111
    120000000222000000020001
    1000000020200000020011111
111111111000N000000200001
1000000000000000000000001
1111111111111111001111111
1111111111111111011111111
1001111111111111011100001111111
1011000000000000000100000000001
1011000000000000000100000000001
1011000002000000000000001111111
1011000000000000000100001
1001011111111111111100001
1000000111010000000000001
1011000000000011110000001
111111111111111  111111111
