R  800 600
NO ./texture/bluestone.xpm
SO ./texture/brick_cool.xpm
WE ./texture/greystone.xpm
EA ./texture/redbrick.xpm
S ./texture/barrel.xpm
F 0,0,0
C 0,0,254

111111111111111111111111111111111111
100000000000000000000000000000000001
100000000000000000000000000000000001
100000000000000000000000000000000001
100000000000000000000000000000000001
100000000000000000000000000000000001
100000000000000000000000000000000001
10000N000000000000000000000000000001
100000000000000000000000000000000001
100000000001111110000000000000000001
100000000001    10000000000000000001
100000000001    10000000000000000001
100000000001111110000000000000000001
100000000000000000000000000000000001
100000000000000000000000000000000001
100000000000002000000000000000000001
100000000200200000000000000000000001
100000000000000000000000000000000001
100000000002000000000000000000000001
111111111111111111111111111111111111
